1111111111111111111111111111111111111111111111111111111111111111111111111111111111111111111111111111111111111AAA00000000000000000000000000000000000000
1AAAAAAAAAAAAAAAAAAAAAAAAAAAAAAAAAAAAAAAAAAAAAAAAAAAAAAAAAAAAAAAAAAAAAAAAAAAAAAAAAAAAAAAAAAAAAAAAAAAAAAAAAA1AAA000000000000000000000000000000000000000
1AAAAAAAAAAAAAAAAAAAAAAAAAAAAAAAAAAAAAAAAAAAAAAAAAAAAAAAAAAAAAAAAAAAAAAAAAAAAAAAAAAAAAAAAAAAAAAAAAAAAAAAAAA1AAA000000000000000000000000000000000000000
1AAAAAAAAAAAAAAAAAAAAAAAAAAAAAAAAAAAAAAAAAAAAAAAAAAAAAAAAAAAAAAAAAAAAAAAAAAAAAAAAAAAAAAAAAAAAAAAAAAAAAAAAAA1AAA000000000000000000000000000000000000000
1AAA0000000000000000000000000000000000000000000000000000000000000000000000000000000000000000000000000000AAA1AAA000000000000000000000000000000000000000
1AAA0000000000000000000000000000000000000000000000000000000000000000000000000000000000000000000000000000AAA1AAA000000000000000000000000000000000000000
1AAA0000000000000000000000000000000000000000000000000000000000000000000000000000000000000000000000000000AAA1AAA000000000000000000000000000000000000000
1AAA0000000000000000000000000000000000000000000000000000000000000000000000000000000000000000000000000000AAA1AAA000000000000000000000000000000000000000
1AAA0000000000000000000000000000000000000000000000000000000000000000000000000000000000000000000000000000AAA1AAA000000000000000000000000000000000000000
1AAA0000000000000000000000000000000000000000000000000000000000000000000000000000000000000000000000000000AAA1AAA000000000000000000000000000000000000000
1AAA0000000000000000000000000000000000000000000000000000000000000000000000000000000000000000000000000000AAA1AAAAAAAAAA00000000000000000000000000000000
1AAA0000000000000000000000000000000000000000000000000000000000000000000000000000000000000000000000000000AAA1AAAAAAAAAA00000000000000000000000000000000
1AAA0000000000000000000000000000000000000000000000000000000000000000000000000000000000000000000000000000AAA1AAAAAAAAAA00000000000000000000000000000000
1AAA0000000000000000000000000000000000000000000000000000000000000000000000000000000000000000000000000000AAA11111111111AAA00000000000000000000000000000
1AAA0000000000000000000000000000000000000000000000000000000000000000000000000000000000000000000000000000000AAAAAAAAAA1AAA00000000000000000000000000000
1AAA0000000000000000000000000000000000000000000000000000000000000000000000000000000000000000000000000000000AAAAAAAAAA1AAA00000000000000000000000000000
1111AAA0000000000000000000000000000000000000000000000000000000000000000000000000000000000000000000000000000AAAAAAAAAA1AAA00000000000000000000000000000
1AAA00000000000000000000000000000000000000000000000000000000000000000000000000000000000000000000000000000000000000AAA1AAA00000000000000000000000000000
1AAA00000000000000000000000000000000000000000000000000000000000000000000000000000000000000000000000000000000000000AAA1AAA00000000000000000000000000000
1AAA00000000000000000000000000000000000000000000000000000000000000000000000000000000000000000000000000000000000000AAA1AAA00000000000000000000000000000
1AAA00000000000000000000000000000000000000000000000000000000000000000000000000000000000000000000000000000000000000AAA1AAA00000000000000000000000000000
1AAA00000000000000000000000000000000000000000000000000000000000000000000000000000000000000000000000000000000000000AAA1AAA00000000000000000000000000000
1AAA00000000000000000000000000000000000000000000000000000000000000000000000000000000000000000000000000000000000000AAA1AAA00000000000000000000000000000
1AAA00000000000000000000000000000000000000000000000000000000000000000000000000000000000000000000000000000000000000AAA1AAA00000000000000000000000000000
1AAA000000000000000000000000000000000AAAAAAAAAAAAAAAAAAAAAAAAAAAAAAAAAAAAAAAAA000000000000000000000000000000000000AAA1AAA00000000000000000000000000000
1AAA000000000000000000000000000000000AAAAAAAAAAAAAAAAAAAAAAAAAAAAAAAAAAAAAAAAA000000000000000000000000000000000000AAA1AAA00000000000000000000000000000
1AAA000000000000000000000000000000000AAAAAAAAAAAAAAAAAAAAAAAAAAAAAAAAAAAAAAAAA000000000000000000000000000000000000AAA1AAA00000000000000000000000000000
1AAA000000000000000000000000000000AAA11111111111111111111111111111111111111111AAA000000000000000000000000000000000AAA1AAA00000000000000000000000000000
1AAA0000000000000000000000000000000AAA1111111111111111111111111111111111111111AAA000000000000000000000000000000000AAA1AAA00000000000000000000000000000
1AAA0000000000000000000000000000000AAA1AAAAAAAAAAAAAAAAAAAAAAAAAAAAAAAAAAAAAAA000000000000000000000000000000000000AAA1AAA00000000000000000000000000000
1AAA0000000000000000000000000000000AAA1AAAAAAAAAAAAAAAAAAAAAAAAAAAAAAAAAAAAAAA000000000000000000000000000000000000AAA1AAA00000000000000000000000000000
1AAA0000000000000000000000000000000AAA1AAAAAAAAAAAAAAAAAAAAAAAAAAAAAAAAAAAAAAA000000000000000000000000000000000000AAA1AAA00000000000000000000000000000
1AAA0000000000000000000000000000000AAA1AAA000000000000000000000000000000000000000000000000000000000000000000000000AAA1AAA00000000000000000000000000000
1AAA0000000000000000000000000000000AAA1AAA000000000000000000000000000000000000000000000000000000000000000000000000AAA1AAA00000000000000000000000000000
1AAA0000000000000000000000000000000AAA1AAA000000000000000000000000000000000000000000000000000000000000000000000000AAA1AAA00000000000000000000000000000
1AAA0000000000000000000000000000000AAA1AAA000000000000000000000000000000000000000000000000000000000000000000000000AAA1AAA00000000000000000000000000000
1AAA0000000000000000000000000000000AAA1AAA000000000000000000000000000000000000000000000000000000000000000000000000AAA1AAA00000000000000000000000000000
1AAA0000000000000000000000000000000AAA1AAA000000000000000000000000000000000000000000000000000000000000000000000000AAA1AAA00000000000000000000000000000
1AAA0000000000000000000000000000000AAA1AAA000000000000000000000000000000000000000000000000000000000000000000000000AAA1AAA00000000000000000000000000000
1AAA0000000000000000000000000000000AAA1AAA000000000000000000000000000000000000000000000000000000000000000000000000AAA1AAA00000000000000000000000000000
1AAA0000000000000000000000000000000AAA1AAA000000000000000000000000000000000000000000000000000000000000000000000000AAA1AAA00000000000000000000000000000
1AAA0000000000000000000000000000000AAA1AAA000000000000000000000000000000000000000000000000000000000000000000000000AAA1AAA00000000000000000000000000000
1AAA0000000000000000000000000000000AAA1AAA000000000000000000000000000000000000000000000000000000000000000000000000AAA1AAA00000000000000000000000000000
1AAA0000000000000000000000000000000AAA1AAA000000000000000000000000000000000000000000000000000000000000000000000000AAA1AAA00000000000000000000000000000
1AAA0000000000000000000000000000000AAA1AAA000000000000000000000000000000000000000000000000000000000000000000000000AAA1AAA00000000000000000000000000000
1AAA0000000000000000000000000000000AAA1AAA000000000000000000000000000000000000000000000000000000000000000000000000AAA1AAA00000000000000000000000000000
1AAA0000000000000000000000000000000AAA1AAA000000000000000000000000000000000000000000000000000000000000000000000000AAA1AAA00000000000000000000000000000
1AAA0000000000000000000000000000000AAA1AAA000000000000000000000000000000000000000000000000000000000000000000000000AAA1AAA00000000000000000000000000000
1AAA0000000000000000000000000000000AAA1AAA000000000000000000000000000000000000000000000000000000000000000000000000AAA1AAA00000000000000000000000000000
1AAA0000000000000000000000000000000AAA1AAA000000000000000000000000000000000000000000000000000000000000000000000000AAA1AAA00000000000000000000000000000
1AAA0000000000000000000000000000000AAA1AAA000000000000000000000AAAAAAAAAAAAAAAA00000000000000000000000000000000000AAA1AAA00000000000000000000000000000
1AAA0000000000000000000000000000000AAA1AAA000000000000000000000AAAAAAAAAAAAAAAA00000000000000000000000000000000000AAA1AAA00000000000000000000000000000
1AAA0000000000000000000000000000000AAA1AAA000000000000000000000AAAAAAAAAAAAAAAA00000000000000000000000000000000000AAA1AAA00000000000000000000000000000
1AAA0000000000000000000000000000000AAA1AAA000000000000000000AAA1111111111111111AAA00000000000000000000000000000000AAA1AAA00000000000000000000000000000
1AAA0000000000000000000000000000000AAA1AAA000000000000000000AAA1111111111111111AAA00000000000000000000000000000000AAA1AAA00000000000000000000000000000
1AAA0000000000000000000000000000000AAA1AAA000000000000000000000AAAAAAAAAAAAAAA1AAA00000000000000000000000000000000AAA1AAA00000000000000000000000000000
1AAA0000000000000000000000000000000AAA1AAA000000000000000000000AAAAAAAAAAAAAAA1AAA00000000000000000000000000000000AAA1AAA00000000000000000000000000000
1AAA0000000000000000000000000000000AAA1AAA000000000000000000000AAAAAAAAAAAAAAA1AAA00000000000000000000000000000000AAA1AAA00000000000000000000000000000
1AAA0000000000000000000000000000000AAA1AAA000000000000000000000000000000000AAA1AAA00000000000000000000000000000000AAA1AAA00000000000000000000000000000
1AAA0000000000000000000000000000000AAA1AAA000000000000000000000000000000000AAA1AAA00000000000000000000000000000000AAA1AAA00000000000000000000000000000
1AAA0000000000000000000000000000000AAA1AAA000000000000000000000000000000000AAA1AAA00000000000000000000000000000000AAA1AAA00000000000000000000000000000
1AAA0000000000000000000000000000000AAA1AAA000000000000000000000000000000000AAA1AAA00000000000000000000000000000000AAA1AAA00000000000000000000000000000
1AAA0000000000000000000000000000000AAA1AAA000000000000000000000000000000000AAA1AAA00000000000000000000000000000000AAA1AAA00000000000000000000000000000
1AAAAAAAAAAAAAAAAAAAAAAAAAAAAAAAAAAAAA1AAA000000000000000000000AAAAAAAAAAAAAAA1AAA00000000000000000000000000000000AAA1AAA00000000000000000000000000000
1AAAAAAAAAAAAAAAAAAAAAAAAAAAAAAAAAAAAA1AAA000000000000000000000AAAAAAAAAAAAAAA1AAA00000000000000000000000000000000AAA1AAA00000000000000000000000000000
1AAAAAAAAAAAAAAAAAAAAAAAAAAAAAAAAAAAAA1AAA000000000000000000000AAAAAAAAAAAAAAA1AAA00000000000000000000000000000000AAA1AAA00000000000000000000000000000
111111111111111111111111111111111111111AAA000000000000000000AAA1111111111111111AAA00000000000000000000000000000000AAA1AAA00000000000000000000000000000
1AAAAAAAAAAAAAAAAAAAAAAAAAAAAAAAAAAAAAA000000000000000000000000AAAAAAAAAAAAAAAA00000000000000000000000000000000000AAA1AAA00000000000000000000000000000
1AAAAAAAAAAAAAAAAAAAAAAAAAAAAAAAAAAAAAA000000000000000000000000AAAAAAAAAAAAAAAA00000000000000000000000000000000000AAA1AAA00000000000000000000000000000
1AAAAAAAAAAAAAAAAAAAAAAAAAAAAAAAAAAAAAA000000000000000000000000AAAAAAAAAAAAAAAA00000000000000000000000000000000000AAA1AAA00000000000000000000000000000
1AAA00000000000000000000000000000000000000000000000000000000000000000000000000000000000000000000000000000000000000AAA1AAA00000000000000000000000000000
1AAA00000000000000000000000000000000000000000000000000000000000000000000000000000000000000000000000000000000000000AAA1AAA00000000000000000000000000000
1AAA00000000000000000000000000000000000000000000000000000000000000000000000000000000000000000000000000000000000000AAA1AAA00000000000000000000000000000
1AAA00000000000000000000000000000000000000000000000000000000000000000000000000000000000000000000000000000000000000AAA1AAA00000000000000000000000000000
1AAA00000000000000000000000000000000000000000000000000000000000000000000000000000000000000000000000000000000000000AAA1AAA00000000000000000000000000000
1AAA00000000000000000000000000000000000000000000000000000000000000000000000000000000000000000000000000000000000000AAA1AAA00000000000000000000000000000
1AAA00000000000000000000000000000000000000000000000000000000000000000000000000000000000000000000000000000000000000AAA1AAA00000000000000000000000000000
1AAA00000000000000000000000000000000000000000000000000000000000000000000000000000000000000000000000000000000000000AAA1AAA00000000000000000000000000000
1AAA00000000000000000000000000000000000000000000000000000000000000000000000000000000000000000000000000000000000000AAA1AAA00000000000000000000000000000
1AAA00000000000000000000000000000000000000000000000000000000000000000000000000000000000000000000000000000000000000AAA1AAA00000000000000000000000000000
1AAA00000000000000000000000000000000000000000000000000000000000000000000000000000000000000000000000000000000000000AAA1AAA00000000000000000000000000000
1AAA00000000000000000000000000000000000000000000000000000000000000000000000000000000000000000000000000000000000000AAA1AAA00000000000000000000000000000
1AAA00000000000000000000000000000000000000000000000000000000000000000000000000000000000000000000000000000000000000AAA1AAA00000000000000000000000000000
1AAA00000000000000000000000000000000000000000000000000000000000000000000000000000000000000000000000000000000000000AAA1AAA00000000000000000000000000000
1AAA00000000000000000000000000000000000000000000000000000000000000000000000000000000000000000000000000000000000000AAA1AAA00000000000000000000000000000
1AAA00000000000000000000000000000000000000000000000000000000000000000000000000000000000000000000000000000000000000AAA1AAA00000000000000000000000000000
1AAA00000000000000000000000000000000000000000000000000000000000000000000000000000000000000000000000000000000000000AAA1AAA00000000000000000000000000000
1AAA00000000000000000000000000000000000000000000000000000000000000000000000000000000000000000000000000000000000000AAA1AAA00000000000000000000000000000
1AAA0000000000000000000000000000000000000000000000000000000000000000000000000AAAAAAAAAAAAAAA0000000000000000000000AAA1AAA00000000000000000000000000000
1AAA0000000000000000000000000000000000000000000000000000000000000000000000000AAAAAAAAAAAAAAA0000000000000000000000AAA1AAA00000000000000000000000000000
1AAA0000000000000000000000000000000000000000000000000000000000000000000000000AAAAAAAAAAAAAAA0000000000000000000000AAA1AAA00000000000000000000000000000
1AAA0000000000000000000000000000000000000000000000000000000000000000000000AAA111111111111111AAA0000000000000000000AAA1AAA00000000000000000000000000000
1AAA00000000000000000000000000000000000000000000000000000000000000000000000AAA11111111111111AAA0000000000000000000AAA1AAA00000000000000000000000000000
1AAA00000000000000000000000000000000000000000000000000000000000000000000000AAA1AAAAAAAAAAAAA0000000000000000000000AAA1AAA00000000000000000000000000000
1AAA00000000000000000000000000000000000000000000000000000000000000000000000AAA1AAAAAAAAAAAAA0000000000000000000000AAA1AAA00000000000000000000000000000
1AAA00000000000000000000000000000000000000000000000000000000000000000000000AAA1AAAAAAAAAAAAA0000000000000000000000AAA1AAA00000000000000000000000000000
1AAA00000000000000000000000000000000000000000000000000000000000000000000000AAA1AAA00000000000000000000000000000000AAA1AAA00000000000000000000000000000
1AAA00000000000000000000000000000000000000000000000000000000000000000000000AAA1AAA00000000000000000000000000000000AAA1AAA00000000000000000000000000000
1AAA00000000000000000000000000000000000000000000000000000000000000000000000AAA1AAA00000000000000000000000000000000AAA1AAA00000000000000000000000000000
1AAA00000000000000000000000000000000000000000000000000000000000000000000000AAA1AAA00000000000000000000000000000000AAA1AAA00000000000000000000000000000
1AAA00000000000000000000000000000000000000000000000000000000000000000000000AAA1AAA00000000000000000000000000000000AAA1AAA00000000000000000000000000000
1AAA00000000000000000000000000000000000000000000000000000000000000000000000AAA1AAA00000000000000000000000000000000AAA1AAA00000000000000000000000000000
1AAA0000000000000000000000000000000000AAAAAAAAAAAAAAAAAAAAAAAAAAAAAAAAAAAAAAAA1AAA00000000000000000000000000000000AAA1AAA00000000000000000000000000000
1AAA0000000000000000000000000000000000AAAAAAAAAAAAAAAAAAAAAAAAAAAAAAAAAAAAAAAA1AAA00000000000000000000000000000000AAA1AAA00000000000000000000000000000
1AAA0000000000000000000000000000000000AAAAAAAAAAAAAAAAAAAAAAAAAAAAAAAAAAAAAAAA1AAA00000000000000000000000000000000AAA1AAA00000000000000000000000000000
1AAA0000000000000000000000000000000AAA11111111111111111111111111111111111111111AAA00000000000000000000000000000000AAA1AAA00000000000000000000000000000
1AAA0000000000000000000000000000000AAA11AAAAAAAAAAAAAAAAAAAAAAAAAAAAAAAAAAAAAA1AAA00000000000000000000000000000000AAA1AAA00000000000000000000000000000
1AAA0000000000000000000000000000000AAA11AAAAAAAAAAAAAAAAAAAAAAAAAAAAAAAAAAAAAA1AAA00000000000000000000000000000000AAA1AAA00000000000000000000000000000
1AAA0000000000000000000000000000000AAA11AAAAAAAAAAAAAAAAAAAAAAAAAAAAAAAAAAAAAA1AAA00000000000000000000000000000000AAA1AAA00000000000000000000000000000
1AAA0000000000000000000000000000000AAA11AAA00000000000000000000000000000000AAA1AAA00000000000000000000000000000000AAA1AAA00000000000000000000000000000
1AAA0000000000000000000000000000000AAA11AAA00000000000000000000000000000000AAA1AAA00000000000000000000000000000000AAA1AAA00000000000000000000000000000
1AAA0000000000000000000000000000000AAA11AAA00000000000000000000000000000000AAA1AAA00000000000000000000000000000000AAA1AAA00000000000000000000000000000
1AAA0000000000000000000000000000000AAA11AAA00000000000000000000000000000000AAA1AAA00000000000000000000000000000000AAA1AAA00000000000000000000000000000
1AAA0000000000000000000000000000000AAA11AAA00000000000000000000000000000000AAA1AAA00000000000000000000000000000000AAA1AAA00000000000000000000000000000
1AAA0000000000000000000000000000000AAA11AAA00000000000000000000000000000000AAA1AAA00000000000000000000000000000000AAA1AAA00000000000000000000000000000
1AAA0000000000000000000000000000000AAA11AAA00000000000000000000000000000000AAA1AAA00000000000000000000000000000000AAA1AAA00000000000000000000000000000
1AAA0000000000000000000000000000000AAA11AAA00000000000000000000000000000000AAA1AAA00000000000000000000000000000000AAA1AAA00000000000000000000000000000
1AAA0000000000000000000000000000000AAA11AAA00000000000000000000000000000000AAA1AAA00000000000000000000000000000000AAA1AAA00000000000000000000000000000
1AAA0000000000000000000000000000000AAA11AAA00000000000000000000000000000000AAA1AAA00000000000000000000000000000000AAA1AAA00000000000000000000000000000
1AAA0000000000000000000000000000000AAA11AAA00000000000000000000000000000000AAA1AAA00000000000000000000000000000000AAA1AAA00000000000000000000000000000
1AAA0000000000000000000000000000000000AA00000000000000000000000000000000000AAA1AAA00000000000000000000000000000000AAA1AAA00000000000000000000000000000
1AAA0000000000000000000000000000000000AA00000000000000000000000000000000000AAA1AAA00000000000000000000000000000000AAA1AAA00000000000000000000000000000
1AAA0000000000000000000000000000000000AA00000000000000000000000000000000000AAA1AAA00000000000000000000000000000000AAA1AAA00000000000000000000000000000
1AAA00000000000000000000000000000000000000000000000000000000000000000000000AAA1AAA00000000000000000000000000000000AAA1AAA00000000000000000000000000000
1AAA00000000000000000000000000000000000000000000000000000000000000000000000AAA1AAA00000000000000000000000000000000AAA1AAA00000000000000000000000000000
1AAA00000000000000000000000000000000000000000000000000000000000000000000000AAA1AAA00000000000000000000000000000000AAA1AAA00000000000000000000000000000
1AAA00000000000000000000000000000000000000000000000000000000000000000000000AAA1AAA00000000000000000000000000000000AAA1AAA00000000000000000000000000000
1AAA00000000000000000000000000000000000000000000000000000000000000000000000AAA1AAA00000000000000000000000000000000AAA1AAA00000000000000000000000000000
1AAA00000000000000000000000000000000000000000000000000000000000000000000000AAA1AAA00000000000000000000000000000000AAA1AAA00000000000000000000000000000
1AAA00000000000000000000000000000000000000000000000000000000000000000000000AAA1AAA00000000000000000000000000000000AAA1AAA00000000000000000000000000000
1AAA00000000000000000000000000000000000000000000000000000000000000000000000AAA1AAA00000000000000000000000000000000AAA1AAA00000000000000000000000000000
1AAA00000000000000000000000000000000000000000000000000000000000000000000000AAA1AAA00000000000000000000000000000000AAA1AAA00000000000000000000000000000
1AAA00000000000000000000000000000000000000000000000000000000000000000000000AAA1AAA00000000000000000000000000000000AAA1AAA00000000000000000000000000000
1AAA00000000000000000000000000000000000000000000000000000000000000000000000AAA1AAA00000000000000000000000000000000AAA1AAA00000000000000000000000000000
1AAA00000000000000000000000000000000000000000000000000000000000000000000000AAA1AAA00000000000000000000000000000000AAA1AAA00000000000000000000000000000
1AAA00000000000000000000000000000000000000000000000000000000000000000000000AAA1AAA00000000000000000000000000000000AAA1AAA00000000000000000000000000000
1AAA00000000000000000000000000000000000000000000000000000000000000000000000AAA1AAA00000000000000000000000000000000AAA1AAA00000000000000000000000000000
1AAA00000000000000000000000000000000000000000000000000000000000000000000000AAA1AAA000000000000000000000000000000AAA111AAA00000000000000000000000000000
1AAA00000000000000000000000000000000000000000000000000000000000000000000000AAA1AAA000000000000000000000000000000AAA1AAA0000000000000000000000000000000
1AAA00000000000000000000000000000000000000000000000000000000000000000000000AAA1AAA000000000000000000000000000000AAA1AAA0000000000000000000000000000000
1AAAAAAAAAAAAAAAAAAAAAAAAAAAAAAAAAAAAAAAAAAAAAAAAAAAAAAAAAAAAAAAAAAAAAAAAAAAAA1AAAAAAAAAAAAAAAAAAAAAAAAAAAAAAAAAAAA1AAA0000000000000000000000000000000
1AAAAAAAAAAAAAAAAAAAAAAAAAAAAAAAAAAAAAAAAAAAAAAAAAAAAAAAAAAAAAAAAAAAAAAAAAAAAA1AAAAAAAAAAAAAAAAAAAAAAAAAAAAAAAAAAAA1AAA0000000000000000000000000000000
1AAAAAAAAAAAAAAAAAAAAAAAAAAAAAAAAAAAAAAAAAAAAAAAAAAAAAAAAAAAAAAAAAAAAAAAAAAAAA1AAAAAAAAAAAAAAAAAAAAAAAAAAAAAAAAAAAA1AAA0000000000000000000000000000000
11111111111111111111111111111111111111111111111111111111111111111111111111111111111111111111111111111111111111111111AAA0000000000000000000000000000000
AAAAAAAAAAAAAAAAAAAAAAAAAAAAAAAAAAAAAAAAAAAAAAAAAAAAAAAAAAAAAAAAAAAAAAAAAAAAAAAAAAAAAAAAAAAAAAAAAAAAAAAAAAAAAAAAAAAA0000000000000000000000000000000000
AAAAAAAAAAAAAAAAAAAAAAAAAAAAAAAAAAAAAAAAAAAAAAAAAAAAAAAAAAAAAAAAAAAAAAAAAAAAAAAAAAAAAAAAAAAAAAAAAAAAAAAAAAAAAAAAAAAA0000000000000000000000000000000000
AAAAAAAAAAAAAAAAAAAAAAAAAAAAAAAAAAAAAAAAAAAAAAAAAAAAAAAAAAAAAAAAAAAAAAAAAAAAAAAAAAAAAAAAAAAAAAAAAAAAAAAAAAAAAAAAAAAA0000000000000000000000000000000000
000000000000000000000000000000000000000000000000000000000000000000000000000000000000000000000000000000000000000000000000000000000000000000000000000000
000000000000000000000000000000000000000000000000000000000000000000000000000000000000000000000000000000000000000000000000000000000000000000000000000000
000000000000000000000000000000000000000000000000000000000000000000000000000000000000000000000000000000000000000000000000000000000000000000000000000000
