1111111111111111111111111111111111111111111111111111111111111111111111111111111111111111111111111111111111111NNN00000000000000000000000000000000000000
1NNNNNNNNNNNNNNNNNNNNNNNNNNNNNNNNNNNNNNNNNNNNNNNNNNNNNNNNNNNNNNNNNNNNNNNNNNNNNNNNNNNNNNNNNNNNNNNNNNNNNNNNNN1NNN000000000000000000000000000000000000000
1NNNNNNNNNNNNNNNNNNNNNNNNNNNNNNNNNNNNNNNNNNNNNNNNNNNNNNNNNNNNNNNNNNNNNNNNNNNNNNNNNNNNNNNNNNNNNNNNNNNNNNNNNN1NNN000000000000000000000000000000000000000
1NNNNNNNNNNNNNNNNNNNNNNNNNNNNNNNNNNNNNNNNNNNNNNNNNNNNNNNNNNNNNNNNNNNNNNNNNNNNNNNNNNNNNNNNNNNNNNNNNNNNNNNNNN1NNN000000000000000000000000000000000000000
1NNN0000000000000000000000000000000000000000000000000000000000000000000000000000000000000000000000000000NNN1NNN000000000000000000000000000000000000000
1NNN0000000000000000000000000000000000000000000000000000000000000000000000000000000000000000000000000000NNN1NNN000000000000000000000000000000000000000
1NNN0000000000000000000000000000000000000000000000000000000000000000000000000000000000000000000000000000NNN1NNN000000000000000000000000000000000000000
1NNN0000000000000000000000000000000000000000000000000000000000000000000000000000000000000000000000000000NNN1NNN000000000000000000000000000000000000000
1NNN0000000000000000000000000000000000000000000000000000000000000000000000000000000000000000000000000000NNN1NNN000000000000000000000000000000000000000
1NNN0000000000000000000000000000000000000000000000000000000000000000000000000000000000000000000000000000NNN1NNN000000000000000000000000000000000000000
1NNN0000000000000000000000000000000000000000000000000000000000000000000000000000000000000000000000000000NNN1NNNNNNNNNN00000000000000000000000000000000
1NNN0000000000000000000000000000000000000000000000000000000000000000000000000000000000000000000000000000NNN1NNNNNNNNNN00000000000000000000000000000000
1NNN0000000000000000000000000000000000000000000000000000000000000000000000000000000000000000000000000000NNN1NNNNNNNNNN00000000000000000000000000000000
1NNN0000000000000000000000000000000000000000000000000000000000000000000000000000000000000000000000000000NNN11111111111NNN00000000000000000000000000000
1NNN0000000000000000000000000000000000000000000000000000000000000000000000000000000000000000000000000000000NNNNNNNNNN1NNN00000000000000000000000000000
1NNN0000000000000000000000000000000000000000000000000000000000000000000000000000000000000000000000000000000NNNNNNNNNN1NNN00000000000000000000000000000
1111NNN0000000000000000000000000000000000000000000000000000000000000000000000000000000000000000000000000000NNNNNNNNNN1NNN00000000000000000000000000000
1NNN00000000000000000000000000000000000000000000000000000000000000000000000000000000000000000000000000000000000000NNN1NNN00000000000000000000000000000
1NNN00000000000000000000000000000000000000000000000000000000000000000000000000000000000000000000000000000000000000NNN1NNN00000000000000000000000000000
1NNN00000000000000000000000000000000000000000000000000000000000000000000000000000000000000000000000000000000000000NNN1NNN00000000000000000000000000000
1NNN00000000000000000000000000000000000000000000000000000000000000000000000000000000000000000000000000000000000000NNN1NNN00000000000000000000000000000
1NNN00000000000000000000000000000000000000000000000000000000000000000000000000000000000000000000000000000000000000NNN1NNN00000000000000000000000000000
1NNN00000000000000000000000000000000000000000000000000000000000000000000000000000000000000000000000000000000000000NNN1NNN00000000000000000000000000000
1NNN00000000000000000000000000000000000000000000000000000000000000000000000000000000000000000000000000000000000000NNN1NNN00000000000000000000000000000
1NNN000000000000000000000000000000000NNNNNNNNNNNNNNNNNNNNNNNNNNNNNNNNNNNNNNNNN000000000000000000000000000000000000NNN1NNN00000000000000000000000000000
1NNN000000000000000000000000000000000NNNNNNNNNNNNNNNNNNNNNNNNNNNNNNNNNNNNNNNNN000000000000000000000000000000000000NNN1NNN00000000000000000000000000000
1NNN000000000000000000000000000000000NNNNNNNNNNNNNNNNNNNNNNNNNNNNNNNNNNNNNNNNN000000000000000000000000000000000000NNN1NNN00000000000000000000000000000
1NNN000000000000000000000000000000NNN11111111111111111111111111111111111111111NNN000000000000000000000000000000000NNN1NNN00000000000000000000000000000
1NNN0000000000000000000000000000000NNN1111111111111111111111111111111111111111NNN000000000000000000000000000000000NNN1NNN00000000000000000000000000000
1NNN0000000000000000000000000000000NNN1NNNNNNNNNNNNNNNNNNNNNNNNNNNNNNNNNNNNNNN000000000000000000000000000000000000NNN1NNN00000000000000000000000000000
1NNN0000000000000000000000000000000NNN1NNNNNNNNNNNNNNNNNNNNNNNNNNNNNNNNNNNNNNN000000000000000000000000000000000000NNN1NNN00000000000000000000000000000
1NNN0000000000000000000000000000000NNN1NNNNNNNNNNNNNNNNNNNNNNNNNNNNNNNNNNNNNNN000000000000000000000000000000000000NNN1NNN00000000000000000000000000000
1NNN0000000000000000000000000000000NNN1NNN000000000000000000000000000000000000000000000000000000000000000000000000NNN1NNN00000000000000000000000000000
1NNN0000000000000000000000000000000NNN1NNN000000000000000000000000000000000000000000000000000000000000000000000000NNN1NNN00000000000000000000000000000
1NNN0000000000000000000000000000000NNN1NNN000000000000000000000000000000000000000000000000000000000000000000000000NNN1NNN00000000000000000000000000000
1NNN0000000000000000000000000000000NNN1NNN000000000000000000000000000000000000000000000000000000000000000000000000NNN1NNN00000000000000000000000000000
1NNN0000000000000000000000000000000NNN1NNN000000000000000000000000000000000000000000000000000000000000000000000000NNN1NNN00000000000000000000000000000
1NNN0000000000000000000000000000000NNN1NNN000000000000000000000000000000000000000000000000000000000000000000000000NNN1NNN00000000000000000000000000000
1NNN0000000000000000000000000000000NNN1NNN000000000000000000000000000000000000000000000000000000000000000000000000NNN1NNN00000000000000000000000000000
1NNN0000000000000000000000000000000NNN1NNN000000000000000000000000000000000000000000000000000000000000000000000000NNN1NNN00000000000000000000000000000
1NNN0000000000000000000000000000000NNN1NNN000000000000000000000000000000000000000000000000000000000000000000000000NNN1NNN00000000000000000000000000000
1NNN0000000000000000000000000000000NNN1NNN000000000000000000000000000000000000000000000000000000000000000000000000NNN1NNN00000000000000000000000000000
1NNN0000000000000000000000000000000NNN1NNN000000000000000000000000000000000000000000000000000000000000000000000000NNN1NNN00000000000000000000000000000
1NNN0000000000000000000000000000000NNN1NNN000000000000000000000000000000000000000000000000000000000000000000000000NNN1NNN00000000000000000000000000000
1NNN0000000000000000000000000000000NNN1NNN000000000000000000000000000000000000000000000000000000000000000000000000NNN1NNN00000000000000000000000000000
1NNN0000000000000000000000000000000NNN1NNN000000000000000000000000000000000000000000000000000000000000000000000000NNN1NNN00000000000000000000000000000
1NNN0000000000000000000000000000000NNN1NNN000000000000000000000000000000000000000000000000000000000000000000000000NNN1NNN00000000000000000000000000000
1NNN0000000000000000000000000000000NNN1NNN000000000000000000000000000000000000000000000000000000000000000000000000NNN1NNN00000000000000000000000000000
1NNN0000000000000000000000000000000NNN1NNN000000000000000000000000000000000000000000000000000000000000000000000000NNN1NNN00000000000000000000000000000
1NNN0000000000000000000000000000000NNN1NNN000000000000000000000000000000000000000000000000000000000000000000000000NNN1NNN00000000000000000000000000000
1NNN0000000000000000000000000000000NNN1NNN000000000000000000000NNNNNNNNNNNNNNNN00000000000000000000000000000000000NNN1NNN00000000000000000000000000000
1NNN0000000000000000000000000000000NNN1NNN000000000000000000000NNNNNNNNNNNNNNNN00000000000000000000000000000000000NNN1NNN00000000000000000000000000000
1NNN0000000000000000000000000000000NNN1NNN000000000000000000000NNNNNNNNNNNNNNNN00000000000000000000000000000000000NNN1NNN00000000000000000000000000000
1NNN0000000000000000000000000000000NNN1NNN000000000000000000NNN1111111111111111NNN00000000000000000000000000000000NNN1NNN00000000000000000000000000000
1NNN0000000000000000000000000000000NNN1NNN000000000000000000NNN1111111111111111NNN00000000000000000000000000000000NNN1NNN00000000000000000000000000000
1NNN0000000000000000000000000000000NNN1NNN000000000000000000000NNNNNNNNNNNNNNN1NNN00000000000000000000000000000000NNN1NNN00000000000000000000000000000
1NNN0000000000000000000000000000000NNN1NNN000000000000000000000NNNNNNNNNNNNNNN1NNN00000000000000000000000000000000NNN1NNN00000000000000000000000000000
1NNN0000000000000000000000000000000NNN1NNN000000000000000000000NNNNNNNNNNNNNNN1NNN00000000000000000000000000000000NNN1NNN00000000000000000000000000000
1NNN0000000000000000000000000000000NNN1NNN000000000000000000000000000000000NNN1NNN00000000000000000000000000000000NNN1NNN00000000000000000000000000000
1NNN0000000000000000000000000000000NNN1NNN000000000000000000000000000000000NNN1NNN00000000000000000000000000000000NNN1NNN00000000000000000000000000000
1NNN0000000000000000000000000000000NNN1NNN000000000000000000000000000000000NNN1NNN00000000000000000000000000000000NNN1NNN00000000000000000000000000000
1NNN0000000000000000000000000000000NNN1NNN000000000000000000000000000000000NNN1NNN00000000000000000000000000000000NNN1NNN00000000000000000000000000000
1NNN0000000000000000000000000000000NNN1NNN000000000000000000000000000000000NNN1NNN00000000000000000000000000000000NNN1NNN00000000000000000000000000000
1NNNNNNNNNNNNNNNNNNNNNNNNNNNNNNNNNNNNN1NNN000000000000000000000NNNNNNNNNNNNNNN1NNN00000000000000000000000000000000NNN1NNN00000000000000000000000000000
1NNNNNNNNNNNNNNNNNNNNNNNNNNNNNNNNNNNNN1NNN000000000000000000000NNNNNNNNNNNNNNN1NNN00000000000000000000000000000000NNN1NNN00000000000000000000000000000
1NNNNNNNNNNNNNNNNNNNNNNNNNNNNNNNNNNNNN1NNN000000000000000000000NNNNNNNNNNNNNNN1NNN00000000000000000000000000000000NNN1NNN00000000000000000000000000000
111111111111111111111111111111111111111NNN000000000000000000NNN1111111111111111NNN00000000000000000000000000000000NNN1NNN00000000000000000000000000000
1NNNNNNNNNNNNNNNNNNNNNNNNNNNNNNNNNNNNNN000000000000000000000000NNNNNNNNNNNNNNNN00000000000000000000000000000000000NNN1NNN00000000000000000000000000000
1NNNNNNNNNNNNNNNNNNNNNNNNNNNNNNNNNNNNNN000000000000000000000000NNNNNNNNNNNNNNNN00000000000000000000000000000000000NNN1NNN00000000000000000000000000000
1NNNNNNNNNNNNNNNNNNNNNNNNNNNNNNNNNNNNNN000000000000000000000000NNNNNNNNNNNNNNNN00000000000000000000000000000000000NNN1NNN00000000000000000000000000000
1NNN00000000000000000000000000000000000000000000000000000000000000000000000000000000000000000000000000000000000000NNN1NNN00000000000000000000000000000
1NNN00000000000000000000000000000000000000000000000000000000000000000000000000000000000000000000000000000000000000NNN1NNN00000000000000000000000000000
1NNN00000000000000000000000000000000000000000000000000000000000000000000000000000000000000000000000000000000000000NNN1NNN00000000000000000000000000000
1NNN00000000000000000000000000000000000000000000000000000000000000000000000000000000000000000000000000000000000000NNN1NNN00000000000000000000000000000
1NNN00000000000000000000000000000000000000000000000000000000000000000000000000000000000000000000000000000000000000NNN1NNN00000000000000000000000000000
1NNN00000000000000000000000000000000000000000000000000000000000000000000000000000000000000000000000000000000000000NNN1NNN00000000000000000000000000000
1NNN00000000000000000000000000000000000000000000000000000000000000000000000000000000000000000000000000000000000000NNN1NNN00000000000000000000000000000
1NNN00000000000000000000000000000000000000000000000000000000000000000000000000000000000000000000000000000000000000NNN1NNN00000000000000000000000000000
1NNN00000000000000000000000000000000000000000000000000000000000000000000000000000000000000000000000000000000000000NNN1NNN00000000000000000000000000000
1NNN00000000000000000000000000000000000000000000000000000000000000000000000000000000000000000000000000000000000000NNN1NNN00000000000000000000000000000
1NNN00000000000000000000000000000000000000000000000000000000000000000000000000000000000000000000000000000000000000NNN1NNN00000000000000000000000000000
1NNN00000000000000000000000000000000000000000000000000000000000000000000000000000000000000000000000000000000000000NNN1NNN00000000000000000000000000000
1NNN00000000000000000000000000000000000000000000000000000000000000000000000000000000000000000000000000000000000000NNN1NNN00000000000000000000000000000
1NNN00000000000000000000000000000000000000000000000000000000000000000000000000000000000000000000000000000000000000NNN1NNN00000000000000000000000000000
1NNN00000000000000000000000000000000000000000000000000000000000000000000000000000000000000000000000000000000000000NNN1NNN00000000000000000000000000000
1NNN00000000000000000000000000000000000000000000000000000000000000000000000000000000000000000000000000000000000000NNN1NNN00000000000000000000000000000
1NNN00000000000000000000000000000000000000000000000000000000000000000000000000000000000000000000000000000000000000NNN1NNN00000000000000000000000000000
1NNN00000000000000000000000000000000000000000000000000000000000000000000000000000000000000000000000000000000000000NNN1NNN00000000000000000000000000000
1NNN0000000000000000000000000000000000000000000000000000000000000000000000000NNNNNNNNNNNNNNN0000000000000000000000NNN1NNN00000000000000000000000000000
1NNN0000000000000000000000000000000000000000000000000000000000000000000000000NNNNNNNNNNNNNNN0000000000000000000000NNN1NNN00000000000000000000000000000
1NNN0000000000000000000000000000000000000000000000000000000000000000000000000NNNNNNNNNNNNNNN0000000000000000000000NNN1NNN00000000000000000000000000000
1NNN0000000000000000000000000000000000000000000000000000000000000000000000NNN111111111111111NNN0000000000000000000NNN1NNN00000000000000000000000000000
1NNN00000000000000000000000000000000000000000000000000000000000000000000000NNN11111111111111NNN0000000000000000000NNN1NNN00000000000000000000000000000
1NNN00000000000000000000000000000000000000000000000000000000000000000000000NNN1NNNNNNNNNNNNN0000000000000000000000NNN1NNN00000000000000000000000000000
1NNN00000000000000000000000000000000000000000000000000000000000000000000000NNN1NNNNNNNNNNNNN0000000000000000000000NNN1NNN00000000000000000000000000000
1NNN00000000000000000000000000000000000000000000000000000000000000000000000NNN1NNNNNNNNNNNNN0000000000000000000000NNN1NNN00000000000000000000000000000
1NNN00000000000000000000000000000000000000000000000000000000000000000000000NNN1NNN00000000000000000000000000000000NNN1NNN00000000000000000000000000000
1NNN00000000000000000000000000000000000000000000000000000000000000000000000NNN1NNN00000000000000000000000000000000NNN1NNN00000000000000000000000000000
1NNN00000000000000000000000000000000000000000000000000000000000000000000000NNN1NNN00000000000000000000000000000000NNN1NNN00000000000000000000000000000
1NNN00000000000000000000000000000000000000000000000000000000000000000000000NNN1NNN00000000000000000000000000000000NNN1NNN00000000000000000000000000000
1NNN00000000000000000000000000000000000000000000000000000000000000000000000NNN1NNN00000000000000000000000000000000NNN1NNN00000000000000000000000000000
1NNN00000000000000000000000000000000000000000000000000000000000000000000000NNN1NNN00000000000000000000000000000000NNN1NNN00000000000000000000000000000
1NNN0000000000000000000000000000000000NNNNNNNNNNNNNNNNNNNNNNNNNNNNNNNNNNNNNNNN1NNN00000000000000000000000000000000NNN1NNN00000000000000000000000000000
1NNN0000000000000000000000000000000000NNNNNNNNNNNNNNNNNNNNNNNNNNNNNNNNNNNNNNNN1NNN00000000000000000000000000000000NNN1NNN00000000000000000000000000000
1NNN0000000000000000000000000000000000NNNNNNNNNNNNNNNNNNNNNNNNNNNNNNNNNNNNNNNN1NNN00000000000000000000000000000000NNN1NNN00000000000000000000000000000
1NNN0000000000000000000000000000000NNN11111111111111111111111111111111111111111NNN00000000000000000000000000000000NNN1NNN00000000000000000000000000000
1NNN0000000000000000000000000000000NNN11NNNNNNNNNNNNNNNNNNNNNNNNNNNNNNNNNNNNNN1NNN00000000000000000000000000000000NNN1NNN00000000000000000000000000000
1NNN0000000000000000000000000000000NNN11NNNNNNNNNNNNNNNNNNNNNNNNNNNNNNNNNNNNNN1NNN00000000000000000000000000000000NNN1NNN00000000000000000000000000000
1NNN0000000000000000000000000000000NNN11NNNNNNNNNNNNNNNNNNNNNNNNNNNNNNNNNNNNNN1NNN00000000000000000000000000000000NNN1NNN00000000000000000000000000000
1NNN0000000000000000000000000000000NNN11NNN00000000000000000000000000000000NNN1NNN00000000000000000000000000000000NNN1NNN00000000000000000000000000000
1NNN0000000000000000000000000000000NNN11NNN00000000000000000000000000000000NNN1NNN00000000000000000000000000000000NNN1NNN00000000000000000000000000000
1NNN0000000000000000000000000000000NNN11NNN00000000000000000000000000000000NNN1NNN00000000000000000000000000000000NNN1NNN00000000000000000000000000000
1NNN0000000000000000000000000000000NNN11NNN00000000000000000000000000000000NNN1NNN00000000000000000000000000000000NNN1NNN00000000000000000000000000000
1NNN0000000000000000000000000000000NNN11NNN00000000000000000000000000000000NNN1NNN00000000000000000000000000000000NNN1NNN00000000000000000000000000000
1NNN0000000000000000000000000000000NNN11NNN00000000000000000000000000000000NNN1NNN00000000000000000000000000000000NNN1NNN00000000000000000000000000000
1NNN0000000000000000000000000000000NNN11NNN00000000000000000000000000000000NNN1NNN00000000000000000000000000000000NNN1NNN00000000000000000000000000000
1NNN0000000000000000000000000000000NNN11NNN00000000000000000000000000000000NNN1NNN00000000000000000000000000000000NNN1NNN00000000000000000000000000000
1NNN0000000000000000000000000000000NNN11NNN00000000000000000000000000000000NNN1NNN00000000000000000000000000000000NNN1NNN00000000000000000000000000000
1NNN0000000000000000000000000000000NNN11NNN00000000000000000000000000000000NNN1NNN00000000000000000000000000000000NNN1NNN00000000000000000000000000000
1NNN0000000000000000000000000000000NNN11NNN00000000000000000000000000000000NNN1NNN00000000000000000000000000000000NNN1NNN00000000000000000000000000000
1NNN0000000000000000000000000000000000NN00000000000000000000000000000000000NNN1NNN00000000000000000000000000000000NNN1NNN00000000000000000000000000000
1NNN0000000000000000000000000000000000NN00000000000000000000000000000000000NNN1NNN00000000000000000000000000000000NNN1NNN00000000000000000000000000000
1NNN0000000000000000000000000000000000NN00000000000000000000000000000000000NNN1NNN00000000000000000000000000000000NNN1NNN00000000000000000000000000000
1NNN00000000000000000000000000000000000000000000000000000000000000000000000NNN1NNN00000000000000000000000000000000NNN1NNN00000000000000000000000000000
1NNN00000000000000000000000000000000000000000000000000000000000000000000000NNN1NNN00000000000000000000000000000000NNN1NNN00000000000000000000000000000
1NNN00000000000000000000000000000000000000000000000000000000000000000000000NNN1NNN00000000000000000000000000000000NNN1NNN00000000000000000000000000000
1NNN00000000000000000000000000000000000000000000000000000000000000000000000NNN1NNN00000000000000000000000000000000NNN1NNN00000000000000000000000000000
1NNN00000000000000000000000000000000000000000000000000000000000000000000000NNN1NNN00000000000000000000000000000000NNN1NNN00000000000000000000000000000
1NNN00000000000000000000000000000000000000000000000000000000000000000000000NNN1NNN00000000000000000000000000000000NNN1NNN00000000000000000000000000000
1NNN00000000000000000000000000000000000000000000000000000000000000000000000NNN1NNN00000000000000000000000000000000NNN1NNN00000000000000000000000000000
1NNN00000000000000000000000000000000000000000000000000000000000000000000000NNN1NNN00000000000000000000000000000000NNN1NNN00000000000000000000000000000
1NNN00000000000000000000000000000000000000000000000000000000000000000000000NNN1NNN00000000000000000000000000000000NNN1NNN00000000000000000000000000000
1NNN00000000000000000000000000000000000000000000000000000000000000000000000NNN1NNN00000000000000000000000000000000NNN1NNN00000000000000000000000000000
1NNN00000000000000000000000000000000000000000000000000000000000000000000000NNN1NNN00000000000000000000000000000000NNN1NNN00000000000000000000000000000
1NNN00000000000000000000000000000000000000000000000000000000000000000000000NNN1NNN00000000000000000000000000000000NNN1NNN00000000000000000000000000000
1NNN00000000000000000000000000000000000000000000000000000000000000000000000NNN1NNN00000000000000000000000000000000NNN1NNN00000000000000000000000000000
1NNN00000000000000000000000000000000000000000000000000000000000000000000000NNN1NNN00000000000000000000000000000000NNN1NNN00000000000000000000000000000
1NNN00000000000000000000000000000000000000000000000000000000000000000000000NNN1NNN000000000000000000000000000000NNN111NNN00000000000000000000000000000
1NNN00000000000000000000000000000000000000000000000000000000000000000000000NNN1NNN000000000000000000000000000000NNN1NNN0000000000000000000000000000000
1NNN00000000000000000000000000000000000000000000000000000000000000000000000NNN1NNN000000000000000000000000000000NNN1NNN0000000000000000000000000000000
1NNNNNNNNNNNNNNNNNNNNNNNNNNNNNNNNNNNNNNNNNNNNNNNNNNNNNNNNNNNNNNNNNNNNNNNNNNNNN1NNNNNNNNNNNNNNNNNNNNNNNNNNNNNNNNNNNN1NNN0000000000000000000000000000000
1NNNNNNNNNNNNNNNNNNNNNNNNNNNNNNNNNNNNNNNNNNNNNNNNNNNNNNNNNNNNNNNNNNNNNNNNNNNNN1NNNNNNNNNNNNNNNNNNNNNNNNNNNNNNNNNNNN1NNN0000000000000000000000000000000
1NNNNNNNNNNNNNNNNNNNNNNNNNNNNNNNNNNNNNNNNNNNNNNNNNNNNNNNNNNNNNNNNNNNNNNNNNNNNN1NNNNNNNNNNNNNNNNNNNNNNNNNNNNNNNNNNNN1NNN0000000000000000000000000000000
11111111111111111111111111111111111111111111111111111111111111111111111111111111111111111111111111111111111111111111NNN0000000000000000000000000000000
NNNNNNNNNNNNNNNNNNNNNNNNNNNNNNNNNNNNNNNNNNNNNNNNNNNNNNNNNNNNNNNNNNNNNNNNNNNNNNNNNNNNNNNNNNNNNNNNNNNNNNNNNNNNNNNNNNNN0000000000000000000000000000000000
NNNNNNNNNNNNNNNNNNNNNNNNNNNNNNNNNNNNNNNNNNNNNNNNNNNNNNNNNNNNNNNNNNNNNNNNNNNNNNNNNNNNNNNNNNNNNNNNNNNNNNNNNNNNNNNNNNNN0000000000000000000000000000000000
NNNNNNNNNNNNNNNNNNNNNNNNNNNNNNNNNNNNNNNNNNNNNNNNNNNNNNNNNNNNNNNNNNNNNNNNNNNNNNNNNNNNNNNNNNNNNNNNNNNNNNNNNNNNNNNNNNNN0000000000000000000000000000000000
000000000000000000000000000000000000000000000000000000000000000000000000000000000000000000000000000000000000000000000000000000000000000000000000000000
000000000000000000000000000000000000000000000000000000000000000000000000000000000000000000000000000000000000000000000000000000000000000000000000000000
000000000000000000000000000000000000000000000000000000000000000000000000000000000000000000000000000000000000000000000000000000000000000000000000000000
